11111111111
10C01110C01
10001E10001
10C01010C01
10001010001
11011011011
1C000P000C1
11111111111