1111111111111111111111
10P00000C0000100000001
100000E000000100000C01
1000000000000000000001
1000C00000000100000001
1111111111111111111111