111111111111111111
100P000C00000C0011
110011000011000001
1C01110000000011C1
10E011111111011111
111111111111111111